0;9,0;1,0;1,0;1,0;5,1;0,0;6,0;1,0;1,0;1,0;10
0;2,2;0,2;1,1;1,1;2,1;3,1;2,1;4,2;4,2;0,0;4
0;5,2;1,1;1,1;5,1;6,1;7,1;8,1;9,1;10,2;4,0;6
1;0,1;0,1;0,1;0,1;0,1;0,1;0,1;0,1;0,1;0,1;0
0;8,2;2,2;5,2;6,1;3,1;2,2;7,2;8,2;9,2;3,0;7
0;2,2;0,2;2,2;10,1;7,1;9,1;8,2;9,2;3,2;0,0;4
0;11,0;3,0;3,0;3,0;3,0;3,0;3,0;3,0;3,0;3,0;12
Teleports
Objects
Enemies
