0;0,0;6,0;4,0;4,0;4,1;8,1;4,1;7,0;4,0;4,0;4,0;5,0;0
0;0,0;3,0;1,0;1,0;1,2;8,1;4,2;7,0;1,0;1,0;1,0;2,0;0
0;0,0;10,1;2,1;0,1;4,1;4,1;4,1;4,1;4,1;0,1;3,0;9,0;0
0;4,1;8,1;4,1;4,1;4,1;4,1;4,1;4,1;4,1;4,1;4,1;7,0;4
0;1,2;8,1;4,1;4,1;4,1;4,1;4,1;4,1;4,1;4,1;4,2;7,0;1
1;4,1;4,1;4,1;4,1;4,1;4,1;4,1;4,1;4,1;4,1;4,1;4,1;4
0;4,0;8,1;4,1;4,1;4,1;4,1;4,1;4,1;4,1;4,1;4,0;7,0;4
0;1,0;8,1;4,1;4,1;4,1;4,1;4,1;4,1;4,1;4,1;4,0;7,0;1
0;0,0;10,1;1,1;0,1;4,1;4,1;4,1;4,1;4,1;0,1;0,0;9,0;0
0;0,0;4,0;4,0;4,0;4,0;8,1;4,0;7,0;4,0;4,0;4,0;4,0;0
0;0,0;1,0;1,0;1,0;1,0;8,1;4,0;7,0;1,0;1,0;1,0;1,0;0
Teleports
Objects
Enemies