1;0,1;1,1;1,1;2,1;0,2;0,1;0,1;2,1;1,1;1,1;0
1;0,3;0,3;1,2;1,2;2,2;3,2;2,2;4,3;4,3;0,1;0
1;0,3;1,2;1,2;5,2;6,2;7,2;8,2;9,2;10,3;4,1;0
2;0,2;0,2;0,2;0,2;0,2;0,2;0,2;0,2;0,2;0,2;0
2;0,2;0,3;5,3;6,2;3,2;2,3;7,3;8,3;9,2;0,2;0
1;0,3;0,3;2,3;10,2;7,2;9,2;8,3;9,3;3,3;0,1;0
1;3,1;0,1;0,1;0,1;0,1;0,1;0,1;0,1;0,1;0,1;4
A;4;128;0;192;MausoleumRoom
Fountain;352;224,Tree;577.5;351
Guapo;352;270,Zombie;300;250
