1;0,1;1,1;1,1;2,1;1,1;0,1;0,2;0,2;0,1;0,1;1,1;1,1;0,1;2,1;1,1;1,1;1,1;1,1;1,1;1,1;1,1;1,1;1,1;1,1;1,1;1,1;1,1;1,1;0
1;0,3;0,3;0,3;0,3;1,2;0,2;0,2;0,2;0,2;0,2;0,2;0,2;0,2;0,2;0,3;4,3;0,3;0,3;1,2;0,2;0,2;0,2;0,3;4,3;0,3;0,3;0,3;0,1;0
1;0,3;0,3;0,3;1,2;0,2;0,2;0,2;0,2;0,2;0,2;0,2;0,2;0,2;0,2;0,2;0,3;4,3;1,2;0,2;0,2;0,2;0,2;0,2;0,3;4,3;0,3;0,3;0,1;0
1;0,3;0,3;1,2;0,2;0,2;0,2;0,2;0,2;0,2;0,2;0,2;0,2;0,2;0,2;0,2;0,2;0,2;0,2;0,2;0,2;0,2;0,2;0,2;0,2;0,3;4,3;0,3;0,1;0
1;0,3;1,2;0,2;0,2;0,2;0,2;0,2;0,2;0,2;0,2;0,2;0,2;0,2;0,2;0,2;0,2;0,2;0,2;0,2;0,2;0,2;0,2;0,2;0,2;0,2;0,3;4,3;0,1;0
1;0,2;0,2;0,2;0,2;0,2;0,2;0,2;0,2;0,2;0,2;0,2;0,2;0,2;0,2;0,2;0,2;0,2;0,2;0,2;0,2;0,2;0,2;0,2;0,2;0,2;0,2;0,3;4,1;0
2;0,2;0,2;0,2;0,2;0,2;0,2;0,2;0,2;0,2;0,2;0,2;0,2;0,2;0,2;0,2;0,2;0,2;0,2;0,2;0,2;0,2;0,2;0,2;0,2;0,2;0,2;0,2;0,2;0
2;0,2;0,2;0,2;0,2;0,2;0,2;0,2;0,2;0,2;0,2;0,2;0,2;0,2;0,2;0,2;0,2;0,2;0,2;0,2;0,2;0,2;0,2;0,2;0,2;0,2;0,2;0,2;0,2;0
1;0,2;0,2;0,2;0,2;0,2;0,2;0,2;0,2;0,2;0,2;0,2;0,2;0,2;0,2;0,2;0,2;0,2;0,2;0,2;0,2;0,2;0,2;0,2;0,2;0,2;0,2;0,2;0,1;0
1;0,3;2,2;0,2;0,2;0,2;0,2;0,2;0,2;0,2;0,2;0,2;0,3;3,3;2,2;0,2;0,2;0,2;0,2;0,2;0,2;0,2;0,3;3,3;2,3;3,3;2,3;3,3;2,1;0
1;0,3;0,3;2,2;0,2;0,3;3,3;2,2;0,2;0,2;0,2;0,3;3,3;0,3;0,3;2,2;0,2;0,2;0,2;0,2;0,2;0,3;3,3;0,3;0,3;0,3;0,3;0,3;0,1;0
1;0,3;0,3;0,3;2,3;3,3;0,3;0,3;2,3;3,3;2,3;3,3;0,3;0,3;0,3;0,3;2,3;3,3;2,3;3,3;2,3;3,3;0,3;0,3;0,3;0,3;0,3;0,3;0,1;0
1;0,3;0,3;0,3;0,3;0,3;0,3;0,3;0,3;0,3;0,3;0,3;0,3;0,3;0,3;0,3;0,3;0,3;0,3;0,3;0,3;0,3;0,3;0,3;0,3;0,3;0,3;0,3;0,1;0
1;3,1;0,1;0,1;0,1;0,1;0,1;0,1;0,1;0,1;0,1;0,1;0,1;0,1;0,1;0,1;0,1;0,1;0,1;0,1;0,1;0,1;0,1;0,1;0,1;0,1;0,1;0,1;0,1;4
H;4;128;1850;384;Room5,J;4;128;0;384;Room3,I;128;4;448;0;Room1

Guapo;100;100,Guapo;100;150,Guapo;50;100,Zombie;250;250,Zombie;400;450
