1;0,1;1,1;2,1;1,1;0
1;0,2;0,2;0,2;0,1;0
1;0,3;7,2;0,2;0,1;0
1;0,2;0,2;0,2;0,1;0
1;0,2;0,2;9,2;0,1;0
1;0,2;0,2;0,2;1,1;0
1;0,2;0,2;0,2;0,1;0
1;0,2;3,2;0,2;0,1;0
1;0,2;0,2;11,2;0,1;0
1;3,1;1,1;1,1;1,1;4
X;40;4;140;555;Room2

Zombie;96;128,Zombie;144;128