1;1,1;1,1;1,1;1,1;1,1;1
1;0,2;0,2;4,2;9,2;3,1;0
1;0,4;0,2;2,2;8,4;2,1;0
1;0,2;6,2;5,2;0,2;1,1;0
1;3,1;0,1;0,1;0,1;0,1;4
T;4;64;80;128;Room4,U;4;64;304;128;Room4

Zombie;196;160
