1;0,1;0,1;2,1;0,1;0
1;0,2;0,2;0,2;0,1;0
1;0,2;0,2;0,2;0,1;0
1;0,2;0,2;0,2;0,1;0
1;0,2;0,2;0,2;0,1;0
1;0,2;0,2;0,2;0,1;0
1;0,2;0,2;0,2;0,1;0
1;0,2;0,2;0,2;0,1;0
1;0,2;0,2;11,2;0,1;0
1;3,1;0,1;0,1;0,1;4
X;40;4;140;555;Room2

Skeleton;128;128,Skeleton;96;128,Skeleton;144;128