1;0,1;1,1;1,1;2,1;1,1;1,1;2,1;1,1;1,1;0
1;0,3;5,3;11,2;6,2;0,2;0,3;8,3;9,2;5,1;0
1;0,2;7,2;1,2;0,2;0,2;0,2;0,2;6,2;4,1;0
1;0,4;0,2;0,2;0,2;0,2;0,2;0,2;0,4;2,1;0
1;0,2;8,2;3,2;0,2;0,2;0,2;0,2;5,2;9,1;0
1;0,2;9,2;10,3;7,2;0,2;0,3;6,2;2,2;7,1;0
1;3,1;1,1;1,1;2,1;1,1;1,1;2,1;1,1;1,1;4
M;4;64;80;192;MausoleumRoom,N;4;64;560;192;Fountain2

Guapo;160;224